111111111111111111111111
1E0000000000000000000001
100000000000P000000000C1
111111111111111111111111