111111111111111111111111
1000000000000000000C0001
1CE000000000000000000001
100000000000P000000000C1
111111111111111111111111