111111111111
1E1CCCC CCC1
10000101CC11
101001001C11
1P1CCCCCCC01
111111111111