111111111111
101000010101
1E1001010111
1000010C1011
1P1000011001
111111111111
1