1111111111111111111111111111111111
1E000000000V000C00000C000000000001
1010010100100000101001000000010101
1010010010101010001001000000010101
1P00V0000C00C000000000000000V000C1
1111111111111111111111111111111111