11111
10V01
10E01
10011
1P0C1
11001
10001
10001
11111